000000000000000000000000
000011111111111111100000
000012200000000055100000
000012200000000055100000
000010000000000000100000
000013300000000044100000
000013300000000044100000
000011111111111111100000
000000000000000000000000
000000007000000700000000
000000000000000000000000
000000000000000000000000

